%%%%%%%%%%
%P.......%
%........%
%........%
%........%
%........%
%%%%%%%%%%
