%%%%%%%%%%
%.P......%
%........%
%........%
%........%
%........%
%%%%%%%%%%
