%%%%%%%%%%%%%%%%%%%%
%..................%
%............%%....%
%..%%....P...%%....%
%..................%
%.....%............%
%%%%%%%%%%%%%%%%%%%%
