%%%%%%%%%%%%%%%%%%%%
%..................%
%..................%
%..................%
%..................%
%.................P%
%%%%%%%%%%%%%%%%%%%%
